Name	read1	read2
sample1	/fast/AG_Ohler/Alison/panakova_CM_RNAseq/raw/R1_pasted_CTATAGTA.fastq	
sample2	/fast/AG_Ohler/Alison/panakova_CM_RNAseq/raw/R1_pasted_CGAGATTC.fastq	
sample3	/fast/AG_Ohler/Alison/panakova_CM_RNAseq/raw/R1_pasted_TCAACTAA.fastq	
sample4	/fast/AG_Ohler/Alison/panakova_CM_RNAseq/raw/R1_pasted_GAATCTCG.fastq	
sample5	/fast/AG_Ohler/Alison/panakova_CM_RNAseq/raw/R1_pasted_TTACGGTG.fastq	
sample6	/fast/AG_Ohler/Alison/panakova_CM_RNAseq/raw/R1_pasted_GCATGTAC.fastq	
sample7	/fast/AG_Ohler/Alison/panakova_CM_RNAseq/raw/R1_pasted_CGATTGAC.fastq	
sample8	/fast/AG_Ohler/Alison/panakova_CM_RNAseq/raw/R1_pasted_TAACTGGC.fastq	
sample9	/fast/AG_Ohler/Alison/panakova_CM_RNAseq/raw/R1_pasted_AGCTAGTC.fastq	
sample10	/fast/AG_Ohler/Alison/panakova_CM_RNAseq/raw/R1_pasted_TACCATAA.fastq	
sample12	/fast/AG_Ohler/Alison/panakova_CM_RNAseq/raw/R1_pasted_ATCTCGGA.fastq	
sample14	/fast/AG_Ohler/Alison/panakova_CM_RNAseq/raw/R1_pasted_TACTGCGA.fastq	
sample15	/fast/AG_Ohler/Alison/panakova_CM_RNAseq/raw/R1_pasted_GCCTTAGA.fastq	
sample16	/fast/AG_Ohler/Alison/panakova_CM_RNAseq/raw/R1_pasted_CACGTATG.fastq	
sample17	/fast/AG_Ohler/Alison/panakova_CM_RNAseq/raw/R1_pasted_CCGTAACA.fastq	
sample18	/fast/AG_Ohler/Alison/panakova_CM_RNAseq/raw/R1_pasted_TTGCAATA.fastq	
sample20	/fast/AG_Ohler/Alison/panakova_CM_RNAseq/raw/R1_pasted_GTGACATC.fastq	
sample21	/fast/AG_Ohler/Alison/panakova_CM_RNAseq/raw/R1_pasted_TCGGCTGG.fastq	
sample22	/fast/AG_Ohler/Alison/panakova_CM_RNAseq/raw/R1_pasted_GAGCCTTA.fastq	
sample23	/fast/AG_Ohler/Alison/panakova_CM_RNAseq/raw/R1_pasted_CAGAGTTC.fastq	
sample24	/fast/AG_Ohler/Alison/panakova_CM_RNAseq/raw/R1_pasted_TGGCTAAC.fastq	
sample19	/fast/AG_Ohler/Alison/panakova_CM_RNAseq/raw/R1_pasted_strange_ACGGCACG.fastq	
